32232223
12023200
32212220
32113122
11011122
13011211
11320111
11022020
